date,ent,evo,int,pri,sai,T
2019-01-01,20,3,81,237,0,20
2019-01-02,41,4,107,207,8,33
2019-01-03,83,7,187,212,4,79
2019-01-04,52,15,168,168,9,43
2019-01-05,35,25,86,118,12,23
2019-01-06,52,21,145,136,9,43
2019-01-07,63,43,140,189,15,48
2019-01-08,60,61,169,154,23,37
2019-01-09,46,56,127,132,19,27
2019-01-10,80,102,173,194,61,19
2019-01-11,41,84,149,131,23,18
2019-01-12,79,77,143,191,16,63
2019-01-13,58,72,156,169,17,41
2019-01-14,45,72,142,161,52,-7
2019-01-15,76,118,167,139,44,32
2019-01-16,69,107,173,126,39,30
2019-01-17,72,111,135,132,31,41
2019-01-18,66,115,116,171,35,31
2019-01-19,50,113,113,149,42,8
2019-01-20,48,103,169,155,43,5
2019-01-21,75,131,146,159,54,21
2019-01-22,69,114,149,127,51,18
2019-01-23,68,123,141,153,74,-6
2019-01-24,36,141,111,148,47,-11
2019-01-25,39,127,148,160,25,14
2019-01-26,64,60,120,157,14,50
2019-01-27,61,68,137,172,17,44
2019-01-28,47,115,157,158,49,-2
2019-01-29,54,106,182,114,36,18
2019-01-30,92,155,219,142,52,40
2019-01-31,62,153,125,175,70,-8
2019-02-01,56,146,147,292,54,2
2019-02-02,38,101,107,173,24,14
2019-02-03,50,92,97,157,16,34
2019-02-04,57,138,200,182,36,21
2019-02-05,70,156,194,167,37,33
2019-02-06,72,152,211,143,44,28
2019-02-07,72,113,190,151,22,50
2019-02-08,41,208,169,221,71,-30
2019-02-09,38,87,94,205,18,20
2019-02-10,63,80,167,253,27,36
2019-02-11,67,173,179,227,77,-10
2019-02-12,90,146,225,265,79,11
2019-02-13,119,154,243,258,63,56
2019-02-14,97,142,215,288,82,15
2019-02-15,52,136,186,303,55,-3
2019-02-16,49,109,227,322,59,-10
2019-02-17,94,90,238,299,16,78
2019-02-18,118,207,294,422,91,27
2019-02-19,99,214,317,354,68,31
2019-02-20,92,217,315,458,80,12
2019-02-21,92,163,361,371,75,17
2019-02-22,118,222,352,345,86,32
2019-02-23,102,186,367,449,39,63
2019-02-24,115,193,325,397,54,61
2019-02-25,159,231,435,411,99,60
2019-02-26,139,214,497,343,107,32
2019-02-27,130,237,412,352,111,19
2019-02-28,125,402,414,458,145,-20
2019-03-01,123,393,367,707,94,29
2019-03-02,150,330,397,510,62,88
2019-03-03,115,291,362,434,70,45
2019-03-04,144,279,443,458,67,77
2019-03-05,102,269,428,413,83,19
2019-03-06,147,376,482,512,75,72
2019-03-07,153,317,496,477,108,45
2019-03-08,140,431,374,531,95,45
2019-03-09,145,402,448,459,53,92
2019-03-10,156,302,404,556,70,86
2019-03-11,181,369,563,492,133,48
2019-03-12,166,403,528,455,208,-42
2019-03-13,179,379,565,444,151,28
2019-03-14,230,375,566,551,126,104
2019-03-15,123,487,405,603,196,-73
2019-03-16,162,302,438,460,99,63
2019-03-17,124,295,410,507,105,19
2019-03-18,155,500,551,593,163,-8
2019-03-19,198,398,613,540,111,87
2019-03-20,218,425,634,710,124,94
2019-03-21,235,393,626,579,112,123
2019-03-22,199,415,457,600,152,47
2019-03-23,185,394,551,577,126,59
2019-03-24,176,276,427,582,121,55
2019-03-25,165,534,605,669,215,-50
2019-03-26,229,441,673,533,187,42
2019-03-27,256,514,631,651,195,61
2019-03-28,208,531,592,550,222,-14
2019-03-29,182,484,531,673,175,7
2019-03-30,169,363,552,665,101,68
2019-03-31,206,417,558,614,71,135
2019-04-01,316,481,729,1027,183,133
2019-04-02,252,491,700,639,212,40
2019-04-03,246,440,698,688,191,55
2019-04-04,228,545,699,777,179,49
2019-04-05,146,578,586,731,148,-2
2019-04-06,253,446,633,755,124,129
2019-04-07,196,359,553,696,84,112
2019-04-08,317,497,854,821,185,132
2019-04-09,275,547,794,738,230,45
2019-04-10,274,652,781,844,213,61
2019-04-11,303,619,847,666,237,66
2019-04-12,217,624,708,804,246,-29
2019-04-13,234,444,516,735,136,98
2019-04-14,177,421,564,829,124,53
2019-04-15,322,668,851,746,337,-15
2019-04-16,338,689,886,687,248,90
2019-04-17,261,623,749,828,231,30
2019-04-18,264,763,676,827,181,83
2019-04-19,217,509,685,834,122,95
2019-04-20,230,451,693,1176,132,98
2019-04-21,294,332,687,855,129,165
2019-04-22,339,650,1001,937,250,89
2019-04-23,360,700,1039,830,294,66
2019-04-24,319,660,954,777,261,58
2019-04-25,363,717,897,857,299,64
2019-04-26,307,815,773,826,260,47
2019-04-27,231,637,752,906,161,70
2019-04-28,307,592,813,790,132,175
2019-04-29,359,685,1021,867,354,5
2019-04-30,382,984,899,851,386,-4
2019-05-01,300,679,837,1160,105,195
2019-05-02,305,674,950,819,322,-17
2019-05-03,313,858,802,1011,303,10
2019-05-04,263,546,769,1059,167,96
2019-05-05,263,652,798,1068,114,149
2019-05-06,428,784,1148,962,379,49
2019-05-07,358,738,987,933,344,14
2019-05-08,296,700,897,895,249,47
2019-05-09,295,762,841,767,247,48
2019-05-10,287,1020,890,1288,363,-76
2019-05-11,334,516,847,968,156,178
2019-05-12,298,583,821,1016,165,133
2019-05-13,414,773,1106,1058,305,109
2019-05-14,319,774,1152,1005,327,-8
2019-05-15,408,846,1135,1122,361,47
2019-05-16,388,854,1073,1018,275,113
2019-05-17,355,882,825,1046,322,33
2019-05-18,286,654,863,1075,175,111
2019-05-19,383,545,975,991,140,243
2019-05-20,448,1084,1156,1392,415,33
2019-05-21,437,859,1220,1065,400,37
2019-05-22,423,946,1143,1008,347,76
2019-05-23,453,998,1146,940,333,120
2019-05-24,450,1002,1053,1194,367,83
2019-05-25,312,713,796,1243,189,123
2019-05-26,317,648,871,1199,197,120
2019-05-27,410,951,1332,1144,513,-103
2019-05-28,412,934,1317,1015,366,46
2019-05-29,424,915,1227,1088,346,78
2019-05-30,444,1126,1149,988,511,-67
2019-05-31,390,1065,1119,1043,440,-50
2019-06-01,436,687,963,1497,200,236
2019-06-02,359,712,969,977,117,242
2019-06-03,348,900,1153,1188,522,-174
2019-06-04,446,1082,1231,962,421,25
2019-06-05,444,1053,1104,1019,431,13
2019-06-06,385,1041,995,1091,491,-106
2019-06-07,386,1116,935,1058,391,-5
2019-06-08,340,582,991,1138,168,172
2019-06-09,410,581,945,1168,109,301
2019-06-10,364,1049,1211,1361,551,-187
2019-06-11,411,993,1178,829,453,-42
2019-06-12,401,972,1314,1087,503,-102
2019-06-13,401,1032,1166,890,356,45
2019-06-14,370,1205,871,989,372,-2
2019-06-15,308,911,754,1013,254,54
2019-06-16,322,714,924,968,166,156
2019-06-17,402,951,1075,836,458,-56
2019-06-18,333,951,1033,850,343,-10
2019-06-19,282,1068,901,890,428,-146
2019-06-20,334,852,824,1077,254,80
2019-06-21,295,745,834,964,232,63
2019-06-22,288,682,831,843,189,99
2019-06-23,246,623,758,789,165,81
2019-06-24,390,786,1022,932,357,33
2019-06-25,362,915,1060,852,378,-16
2019-06-26,368,1072,1070,816,405,-37
2019-06-27,370,914,836,668,411,-41
2019-06-28,282,1100,774,852,354,-72
2019-06-29,242,630,719,681,167,75
2019-06-30,304,684,764,809,183,121
2019-07-01,291,752,838,1017,412,-121
2019-07-02,364,918,1056,747,322,42
2019-07-03,349,757,825,578,447,-98
2019-07-04,242,841,684,612,523,-281
2019-07-05,236,874,719,710,421,-185
2019-07-06,265,651,497,606,168,97
2019-07-07,232,501,595,678,165,67
2019-07-08,178,783,676,801,417,-239
2019-07-09,232,739,654,673,291,-59
2019-07-10,278,751,745,756,373,-95
2019-07-11,256,659,754,687,336,-80
2019-07-12,228,732,696,860,357,-129
2019-07-13,266,529,605,590,118,148
2019-07-14,266,353,666,769,122,144
2019-07-15,335,656,860,664,314,21
2019-07-16,296,656,732,595,302,-6
2019-07-17,337,741,769,544,262,75
2019-07-18,258,666,623,610,222,36
2019-07-19,242,720,610,632,319,-77
2019-07-20,189,477,532,730,184,5
2019-07-21,223,372,505,550,138,85
2019-07-22,315,584,768,651,480,-165
2019-07-23,294,684,813,588,347,-53
2019-07-24,234,649,548,439,288,-54
2019-07-25,233,654,598,534,354,-121
2019-07-26,166,618,506,535,327,-161
2019-07-27,167,486,470,530,194,-27
2019-07-28,170,365,453,375,124,46
2019-07-29,258,575,507,522,354,-96
2019-07-30,209,630,566,406,424,-215
2019-07-31,177,581,457,415,300,-123
2019-08-01,220,565,597,724,319,-99
2019-08-02,160,581,508,536,255,-95
2019-08-03,142,395,358,400,91,51
2019-08-04,176,288,419,494,100,76
2019-08-05,146,495,500,490,339,-193
2019-08-06,183,471,560,446,280,-97
2019-08-07,191,528,568,462,305,-114
2019-08-08,234,512,545,503,185,49
2019-08-09,135,479,382,429,247,-112
2019-08-10,141,353,368,551,82,59
2019-08-11,139,314,349,447,110,29
2019-08-12,213,416,587,476,324,-111
2019-08-13,165,424,526,489,222,-57
2019-08-14,189,420,563,463,239,-50
2019-08-15,184,451,545,586,199,-15
2019-08-16,192,565,403,495,231,-39
2019-08-17,156,402,432,491,62,94
2019-08-18,151,288,374,462,84,67
2019-08-19,150,443,551,472,226,-76
2019-08-20,153,517,484,558,285,-132
2019-08-21,170,433,498,427,307,-137
2019-08-22,209,394,519,444,156,53
2019-08-23,165,541,468,393,141,24
2019-08-24,205,328,343,526,87,118
2019-08-25,172,209,438,441,93,79
2019-08-26,163,493,517,447,317,-154
2019-08-27,170,429,483,427,242,-72
2019-08-28,235,459,564,373,256,-21
2019-08-29,179,425,435,430,224,-45
2019-08-30,139,591,442,450,172,-33
2019-08-31,138,315,341,396,106,32
2019-09-01,143,184,367,538,82,61
2019-09-02,141,350,474,459,294,-153
2019-09-03,167,500,466,353,216,-49
2019-09-04,157,410,409,408,228,-71
2019-09-05,193,411,480,396,187,6
2019-09-06,167,546,389,392,206,-39
2019-09-07,112,255,297,348,93,19
2019-09-08,168,219,327,410,71,97
2019-09-09,152,420,452,558,307,-155
2019-09-10,192,429,491,441,221,-29
2019-09-11,147,315,445,373,197,-50
2019-09-12,219,444,481,338,151,68
2019-09-13,150,351,316,334,201,-51
2019-09-14,163,268,290,337,76,87
2019-09-15,87,293,292,384,84,3
2019-09-16,165,373,484,354,214,-49
2019-09-17,145,371,376,280,189,-44
2019-09-18,141,439,354,351,212,-71
2019-09-19,174,320,378,398,165,9
2019-09-20,94,392,337,383,217,-123
2019-09-21,100,268,276,326,88,12
2019-09-22,147,233,261,252,79,68
2019-09-23,134,383,418,337,220,-86
2019-09-24,136,295,391,391,179,-43
2019-09-25,98,323,353,306,131,-33
2019-09-26,63,333,350,321,231,-168
2019-09-27,112,361,271,321,138,-26
2019-09-28,111,215,288,318,74,37
2019-09-29,152,253,373,305,52,100
2019-09-30,111,327,320,367,199,-88
2019-10-01,142,391,379,385,183,-41
2019-10-02,190,335,364,341,100,90
2019-10-03,112,267,370,278,169,-57
2019-10-04,127,275,297,406,196,-69
2019-10-05,89,195,312,354,60,29
2019-10-06,98,171,307,360,53,45
2019-10-07,160,298,374,304,120,40
2019-10-08,117,384,359,283,155,-38
2019-10-09,143,281,334,275,199,-56
2019-10-10,160,357,322,353,154,6
2019-10-11,84,377,237,324,135,-51
2019-10-12,121,220,269,349,72,49
2019-10-13,116,152,219,313,44,72
2019-10-14,145,293,388,345,207,-62
2019-10-15,130,298,388,354,166,-36
2019-10-16,131,288,337,318,138,-7
2019-10-17,130,332,345,274,97,33
2019-10-18,139,309,324,281,143,-4
2019-10-19,140,208,284,311,74,66
2019-10-20,151,228,302,377,81,70
2019-10-21,135,245,342,356,156,-21
2019-10-22,136,286,351,288,137,-1
2019-10-23,152,264,361,295,121,31
2019-10-24,117,317,356,238,102,15
2019-10-25,75,362,311,335,116,-41
2019-10-26,82,193,188,294,56,26
2019-10-27,100,176,280,232,36,64
2019-10-28,96,263,271,327,119,-23
2019-10-29,127,228,311,283,149,-22
2019-10-30,111,340,307,257,211,-100
2019-10-31,125,237,311,200,162,-37
2019-11-01,70,318,228,344,128,-58
2019-11-02,78,202,200,284,51,27
2019-11-03,100,141,246,230,65,35
2019-11-04,138,215,284,242,125,13
2019-11-05,135,300,371,224,200,-65
2019-11-06,106,260,225,262,178,-72
2019-11-07,100,206,258,234,108,-8
2019-11-08,91,332,271,292,182,-91
2019-11-09,67,192,156,220,48,19
2019-11-10,59,175,204,241,51,8
2019-11-11,96,216,255,209,162,-66
2019-11-12,106,235,295,253,120,-14
2019-11-13,81,258,208,205,138,-57
2019-11-14,123,218,277,240,90,33
2019-11-15,77,218,142,232,71,6
2019-11-16,95,146,157,251,55,40
2019-11-17,62,100,189,266,38,24
2019-11-18,129,223,333,287,132,-3
2019-11-19,78,218,233,248,140,-62
2019-11-20,117,185,249,283,96,21
2019-11-21,116,230,321,203,132,-16
2019-11-22,118,260,224,200,120,-2
2019-11-23,112,154,250,250,40,72
2019-11-24,139,80,233,262,57,82
2019-11-25,89,234,266,302,121,-32
2019-11-26,101,219,270,222,154,-53
2019-11-27,86,271,248,219,128,-42
2019-11-28,111,207,324,264,114,-3
2019-11-29,66,290,184,188,105,-39
2019-11-30,65,226,154,205,52,13
2019-12-01,79,135,204,287,63,16
2019-12-02,102,224,310,300,177,-75
2019-12-03,104,227,275,254,145,-41
2019-12-04,82,174,262,177,124,-42
2019-12-05,73,241,203,240,94,-21
2019-12-06,104,267,233,227,79,25
2019-12-07,76,115,178,255,42,34
2019-12-08,76,106,209,251,33,43
2019-12-09,86,247,236,271,141,-55
2019-12-10,136,257,296,296,122,14
2019-12-11,116,209,270,242,74,42
2019-12-12,112,180,299,226,101,11
2019-12-13,120,310,251,206,134,-14
2019-12-14,108,137,225,190,53,55
2019-12-15,88,140,200,263,48,40
2019-12-16,115,238,281,216,124,-9
2019-12-17,101,182,233,199,138,-37
2019-12-18,101,250,223,205,79,22
2019-12-19,117,210,253,209,159,-42
2019-12-20,57,250,192,302,93,-36
2019-12-21,65,144,182,152,50,15
2019-12-22,72,124,198,166,30,42
2019-12-23,73,274,221,200,161,-88
2019-12-24,94,285,169,204,43,51
2019-12-25,96,96,169,175,32,64
2019-12-26,90,161,228,243,188,-98
2019-12-27,97,168,214,203,80,17
2019-12-28,94,121,179,139,37,57
2019-12-29,78,124,153,0,44,34
2019-12-30,45,236,127,0,115,-70
2019-12-31,33,210,77,0,40,-7
2020-01-01,47,8,142,401,4,43
2020-01-02,55,19,138,242,3,52
2020-01-03,74,29,192,234,24,50
2020-01-04,90,18,147,208,3,87
2020-01-05,92,53,157,260,33,59
2020-01-06,73,89,209,270,19,54
2020-01-07,94,68,196,237,18,76
2020-01-08,73,90,216,229,28,45
2020-01-09,81,130,177,175,33,48
2020-01-10,85,161,252,278,38,47
2020-01-11,90,101,191,193,25,65
2020-01-12,55,103,144,205,40,15
2020-01-13,107,68,199,221,39,68
2020-01-14,80,121,229,266,56,24
2020-01-15,109,139,261,325,46,63
2020-01-16,91,173,215,260,50,41
2020-01-17,66,151,212,258,61,5
2020-01-18,116,117,206,210,69,47
2020-01-19,80,128,188,214,51,29
2020-01-20,115,119,231,271,67,48
2020-01-21,97,149,216,210,52,45
2020-01-22,76,151,197,221,55,21
2020-01-23,76,145,193,229,46,30
2020-01-24,111,235,215,221,42,69
2020-01-25,100,150,181,260,43,57
2020-01-26,88,111,169,241,40,48
2020-01-27,91,142,200,248,50,41
2020-01-28,104,139,240,211,32,72
2020-01-29,67,170,269,244,54,13
2020-01-30,113,182,220,277,51,62
2020-01-31,102,138,194,252,70,32
2020-02-01,60,133,164,342,48,12
2020-02-02,80,146,203,245,55,25
2020-02-03,113,156,232,271,49,64
2020-02-04,68,155,264,303,48,20
2020-02-05,80,177,226,270,54,26
2020-02-06,86,183,187,232,61,25
2020-02-07,110,218,217,304,54,56
2020-02-08,31,137,196,232,35,-4
2020-02-09,117,108,200,289,46,71
2020-02-10,147,220,264,368,119,28
2020-02-11,83,199,292,267,50,33
2020-02-12,70,272,274,323,97,-27
2020-02-13,109,188,260,306,35,74
2020-02-14,119,219,260,399,43,76
2020-02-15,85,128,249,339,54,31
2020-02-16,106,99,255,409,49,57
2020-02-17,194,207,362,536,65,129
2020-02-18,71,222,363,406,78,-7
2020-02-19,182,239,448,427,60,122
2020-02-20,184,260,434,573,95,89
2020-02-21,107,276,279,464,69,38
2020-02-22,125,244,304,497,52,73
2020-02-23,127,204,320,460,51,76
2020-02-24,117,265,357,574,71,46
2020-02-25,186,228,435,704,83,103
2020-02-26,201,237,545,594,53,148
2020-02-27,217,314,656,644,103,114
2020-02-28,176,403,555,647,122,54
2020-02-29,175,356,373,612,113,62
2020-03-01,151,260,439,1220,56,95
2020-03-02,174,472,548,898,101,73
2020-03-03,206,434,581,855,102,104
2020-03-04,219,374,622,736,70,149
2020-03-05,162,457,524,994,134,28
2020-03-06,182,461,557,1110,68,114
2020-03-07,210,301,465,1084,95,115
2020-03-08,188,234,531,1343,67,121
2020-03-09,241,457,842,1817,133,108
2020-03-10,234,467,686,2482,113,121
2020-03-11,310,404,918,2157,82,228
2020-03-12,394,488,1220,2935,104,290
2020-03-13,392,715,1227,3449,126,266
2020-03-14,430,490,1237,3875,124,306
2020-03-15,495,441,1542,5006,145,350
2020-03-16,869,908,2485,5798,236,633
2020-03-17,980,850,2828,5417,223,757
2020-03-18,1292,1255,3573,6243,312,980
2020-03-19,1466,1463,4096,6340,370,1096
2020-03-20,1482,2133,4528,9200,528,954
2020-03-21,1500,2022,4199,6721,434,1066
2020-03-22,1557,1825,4514,6677,448,1109
2020-03-23,2125,3142,6504,8618,670,1455
2020-03-24,1947,3300,6149,7110,690,1257
2020-03-25,1971,3498,6348,7389,669,1302
2020-03-26,2308,3577,6957,7100,788,1520
2020-03-27,2173,3948,6923,7070,845,1328
2020-03-28,1942,3453,5978,6729,768,1174
2020-03-29,2063,3089,6007,6476,578,1485
2020-03-30,2246,4730,7995,7255,935,1311
2020-03-31,2473,4890,7102,6435,858,1615
2020-04-01,2103,4938,6826,10530,1004,1099
2020-04-02,2164,5299,7133,7570,1122,1042
2020-04-03,2102,5671,6459,7824,994,1108
2020-04-04,2194,4393,6202,8207,848,1346
2020-04-05,2000,4547,5764,8202,938,1062
2020-04-06,2519,5552,7649,8657,1176,1343
2020-04-07,2314,5925,7519,8317,1175,1139
2020-04-08,2300,5632,7463,8513,1079,1221
2020-04-09,2154,5691,6986,9156,1088,1066
2020-04-10,2184,5511,6786,12868,1109,1075
2020-04-11,2045,4880,6917,8706,897,1148
2020-04-12,2162,4746,6618,10224,1039,1123
2020-04-13,2391,6228,8779,11142,1267,1124
2020-04-14,2832,6427,9408,11055,1151,1681
2020-04-15,2620,6288,9039,12756,1190,1430
2020-04-16,2922,6635,9135,10989,1189,1733
2020-04-17,2697,7242,9010,11931,1306,1391
2020-04-18,2733,5791,7852,12911,1084,1649
2020-04-19,2374,5834,8310,12063,1160,1214
2020-04-20,2830,7754,10672,19521,1489,1341
2020-04-21,3147,6702,10164,11644,1323,1824
2020-04-22,3501,7824,11985,13021,1436,2065
2020-04-23,3599,8215,12300,13587,1472,2127
2020-04-24,3473,8915,12457,13995,1608,1865
2020-04-25,3077,7326,10652,15156,1395,1682
2020-04-26,3195,7234,10903,13725,1276,1919
2020-04-27,3725,9812,13904,14604,1757,1968
2020-04-28,3835,10472,14040,15005,1747,2088
2020-04-29,3753,10369,13651,12110,1724,2029
2020-04-30,3700,11504,13411,15793,1809,1891
2020-05-01,3644,9791,12996,24131,1519,2125
2020-05-02,3505,9340,12174,15503,1753,1752
2020-05-03,3539,8775,11527,15225,1529,2010
2020-05-04,3955,11173,15252,16667,2038,1917
2020-05-05,4263,12009,14738,17254,2071,2192
2020-05-06,4082,11165,14979,14151,1926,2156
2020-05-07,3810,11402,13861,14955,1860,1950
2020-05-08,3873,12159,13707,15773,2129,1744
2020-05-09,3570,10270,12249,14746,1672,1898
2020-05-10,3583,10143,12244,21981,1723,1860
2020-05-11,4185,11906,15837,15694,2085,2100
2020-05-12,4257,12226,15678,15268,2084,2173
2020-05-13,4163,11914,15511,14665,2087,2076
2020-05-14,4129,12036,15139,15496,2007,2122
2020-05-15,3913,13255,14698,18506,2108,1805
2020-05-16,3780,11164,12814,14596,1727,2053
2020-05-17,3741,10092,13150,14426,1629,2112
2020-05-18,4445,13268,15886,16265,2206,2239
2020-05-19,4287,13620,15535,13808,2116,2171
2020-05-20,4540,13829,15421,20116,2324,2216
2020-05-21,4395,12948,15225,13582,2173,2222
2020-05-22,4286,13422,14907,13979,2165,2121
2020-05-23,3948,10872,12964,12712,1854,2094
2020-05-24,3922,9998,12132,12454,1802,2120
2020-05-25,4245,14033,14916,17174,2475,1770
2020-05-26,4038,13082,14431,12930,2109,1929
2020-05-27,4226,13303,14008,12527,2191,2035
2020-05-28,4142,12992,13412,14218,2428,1714
2020-05-29,4006,13314,13586,13455,2263,1743
2020-05-30,3841,11754,11856,13618,2017,1824
2020-05-31,3758,9911,11340,12557,1773,1985
2020-06-01,4508,12271,14685,23531,2386,2122
2020-06-02,4278,12888,14426,14723,2348,1930
2020-06-03,4388,13062,13960,14201,2391,1997
2020-06-04,4371,13059,14078,14036,2349,2022
2020-06-05,4183,13165,13508,16291,2487,1696
2020-06-06,4245,11219,12748,14577,2135,2110
2020-06-07,3787,9410,11520,13389,1951,1836
2020-06-08,4236,13164,14704,15764,2404,1832
2020-06-09,4490,12382,14636,13732,2280,2210
2020-06-10,4558,13664,14655,19353,2518,2040
2020-06-11,4123,11554,13351,13677,2215,1908
2020-06-12,4357,13071,13571,15459,2350,2007
2020-06-13,4197,10536,12784,14005,2147,2050
2020-06-14,3990,9816,12062,14680,1792,2198
2020-06-15,4333,13223,14244,18621,2511,1822
2020-06-16,4650,13246,15090,14858,2454,2196
2020-06-17,4575,13039,14528,14392,2382,2193
2020-06-18,4671,13447,15075,15619,2259,2412
2020-06-19,4617,13803,14634,15647,2491,2126
2020-06-20,4372,11607,13192,20716,2237,2135
2020-06-21,3752,9803,11800,13333,2158,1594
2020-06-22,4527,13553,15381,15694,2595,1932
2020-06-23,4564,13192,15156,13887,2486,2078
2020-06-24,4289,13071,14364,13750,2450,1839
2020-06-25,4281,13476,15161,15874,2653,1628
2020-06-26,4695,14142,14788,16245,2387,2308
2020-06-27,3915,11039,12172,13654,1990,1925
2020-06-28,4128,10476,12267,15011,2177,1951
2020-06-29,4786,13676,15390,14551,2627,2159
2020-06-30,4588,14581,15457,16289,2568,2020
2020-07-01,4775,13704,15340,24255,2589,2186
2020-07-02,4738,13653,15236,16449,2575,2163
2020-07-03,4729,13646,14873,17064,2451,2278
2020-07-04,4350,10831,13183,15389,2108,2242
2020-07-05,4201,10351,13476,16364,2245,1956
2020-07-06,4915,14070,16558,17151,2771,2144
2020-07-07,5090,14005,16557,16267,2789,2301
2020-07-08,4851,14100,17058,15763,2813,2038
2020-07-09,4873,13298,16037,15238,2717,2156
2020-07-10,4702,15267,16193,22103,2695,2007
2020-07-11,4166,11843,14129,14151,2210,1956
2020-07-12,4456,11747,13489,14958,2322,2134
2020-07-13,4883,14445,17360,16367,2887,1996
2020-07-14,4913,14600,16256,14357,2521,2392
2020-07-15,4746,15512,16106,16868,2799,1947
2020-07-16,4631,13835,15246,14748,2574,2057
2020-07-17,4945,15568,15749,16211,2909,2036
2020-07-18,4190,11810,13141,14791,2405,1785
2020-07-19,4304,11344,13051,14087,2356,1948
2020-07-20,4926,15060,16728,20896,2871,2055
2020-07-21,4927,15268,16333,13524,2806,2121
2020-07-22,4638,14931,15285,13629,2781,1857
2020-07-23,4639,14259,15693,13473,2716,1923
2020-07-24,4726,14539,15205,13716,2707,2019
2020-07-25,4069,12080,12570,15121,2398,1671
2020-07-26,3870,10099,12149,13197,2213,1657
2020-07-27,4806,14708,15939,15504,2977,1829
2020-07-28,4744,14403,15513,13372,2712,2032
2020-07-29,4429,14172,14228,11579,2885,1544
2020-07-30,4643,14768,14235,12492,2905,1738
2020-07-31,4239,14713,13624,12947,2621,1618
2020-08-01,3813,11500,11905,19841,2318,1495
2020-08-02,3927,9950,11405,13004,2197,1730
2020-08-03,4485,13753,14237,14124,2873,1612
2020-08-04,4349,13573,14301,12336,2848,1501
2020-08-05,4271,13601,13807,13236,2873,1398
2020-08-06,4146,12808,13239,12552,2584,1562
2020-08-07,4066,13726,12941,13914,2513,1553
2020-08-08,3832,11094,11385,13383,2299,1533
2020-08-09,3680,9352,10995,12543,2088,1592
2020-08-10,4512,12955,15234,19123,2924,1588
2020-08-11,4421,12096,14566,11859,2458,1963
2020-08-12,4399,12526,14025,12756,2620,1779
2020-08-13,4256,12582,13864,12365,2687,1569
2020-08-14,3971,13080,13289,13138,2561,1410
2020-08-15,3672,10858,11051,13695,2291,1381
2020-08-16,3533,9158,10704,11555,1957,1576
2020-08-17,4236,12822,13761,12456,2519,1717
2020-08-18,4186,12722,13701,12483,2678,1508
2020-08-19,4041,12855,13523,11126,2524,1517
2020-08-20,4001,12507,13000,16057,2447,1554
2020-08-21,3863,13173,11286,11857,2347,1516
2020-08-22,3523,9996,10131,11015,2010,1513
2020-08-23,3494,8926,10030,11047,2072,1422
2020-08-24,4256,11986,13855,11866,2411,1845
2020-08-25,4297,11893,13213,12632,2520,1777
2020-08-26,3744,12024,12663,10964,2402,1342
2020-08-27,3938,11725,13026,10840,2408,1530
2020-08-28,3942,12927,12143,12631,2610,1332
2020-08-29,3600,9383,10507,9814,1850,1750
2020-08-30,3439,9013,10198,10846,2091,1348
2020-08-31,3886,11962,12743,11117,2470,1416
2020-09-01,3806,11834,12205,16160,2609,1197
2020-09-02,3546,11877,11203,10533,2486,1060
2020-09-03,3751,11604,11853,10035,2319,1432
2020-09-04,3510,12513,10959,10592,2408,1102
2020-09-05,3102,9153,9319,11054,1908,1194
2020-09-06,2974,8482,9258,9579,1928,1046
2020-09-07,3398,9204,10210,10564,2226,1172
2020-09-08,3635,10566,11889,10324,2244,1391
2020-09-09,3520,10516,11432,10131,2117,1403
2020-09-10,3267,10899,10885,13037,2144,1123
2020-09-11,3426,11086,10733,9844,2155,1271
2020-09-12,3103,8767,9138,9269,1974,1129
2020-09-13,2861,7802,8615,9494,1816,1045
2020-09-14,3204,10820,10986,10611,2193,1011
2020-09-15,3210,10834,10385,10673,2234,976
2020-09-16,3366,10376,10753,8972,2056,1310
2020-09-17,3190,10129,10497,9338,2170,1020
2020-09-18,3061,10357,10231,9870,1997,1064
2020-09-19,2880,8431,8916,8787,1744,1136
2020-09-20,2730,7343,8214,12506,1759,971
2020-09-21,3549,9826,10242,9197,2039,1510
2020-09-22,2988,9699,9549,8210,1909,1079
2020-09-23,3229,9533,9714,8525,1670,1559
2020-09-24,3049,9722,9676,8412,1771,1278
2020-09-25,2898,10125,9310,10149,1891,1007
2020-09-26,2888,7544,8453,7936,1473,1415
2020-09-27,2732,6526,7991,8330,1504,1228
2020-09-28,3182,9053,10352,9447,1914,1268
2020-09-29,3131,9502,9979,7999,1884,1247
2020-09-30,3036,10341,9802,9019,2027,1009
2020-10-01,3002,9251,9560,13634,2150,852
2020-10-02,2986,9749,9327,9394,1832,1154
2020-10-03,2657,7545,8258,8437,1502,1155
2020-10-04,2684,6622,7991,8512,1554,1130
2020-10-05,3117,9079,10112,9581,2059,1058
2020-10-06,3086,8957,9759,8281,1948,1138
2020-10-07,2989,8729,9386,8144,1911,1078
2020-10-08,2908,8848,9096,8268,1797,1111
2020-10-09,2733,9477,8131,8482,1680,1053
2020-10-10,2616,7876,7376,11216,1616,1000
2020-10-11,2403,6122,6692,7076,1503,900
2020-10-12,2492,6464,7776,8463,1442,1050
2020-10-13,2864,8127,9206,8129,1676,1188
2020-10-14,2809,8395,8890,7643,1717,1092
2020-10-15,2658,8629,8317,9298,1791,867
2020-10-16,2627,8474,7884,8456,1712,915
2020-10-17,2270,6328,6934,7561,1218,1052
2020-10-18,2104,5558,6737,8243,1185,919
2020-10-19,2800,7487,9113,8408,1602,1198
2020-10-20,2716,7883,8550,10610,1603,1113
2020-10-21,2703,7663,8344,7421,1492,1211
2020-10-22,2652,7538,8155,7733,1492,1160
2020-10-23,2480,7618,7876,7700,1418,1062
2020-10-24,2528,5832,7126,7263,1189,1339
2020-10-25,2323,5519,6706,8701,1295,1028
2020-10-26,2799,7102,8826,8327,1640,1159
2020-10-27,2552,7576,8371,7597,1619,933
2020-10-28,2655,7470,8407,8010,1657,998
2020-10-29,2632,7393,8224,7265,1549,1083
2020-10-30,2341,8319,7196,8784,1596,745
2020-10-31,2216,5888,6418,6920,1236,980
2020-11-01,2606,5353,6688,12893,1261,1345
2020-11-02,2556,5350,7679,9373,1170,1386
2020-11-03,2853,6850,8625,9108,1480,1373
2020-11-04,3061,7363,8749,9151,1647,1414
2020-11-05,2688,7323,8221,10168,1596,1092
2020-11-06,2660,7527,8025,10025,1509,1151
2020-11-07,2569,5732,7390,9674,1244,1325
2020-11-08,2396,5040,7059,10493,1285,1111
2020-11-09,2793,6617,9128,11106,1515,1278
2020-11-10,3174,7308,9618,13513,1669,1505
2020-11-11,3139,7732,9637,10349,1563,1576
2020-11-12,3000,7637,9626,10514,1641,1359
2020-11-13,3313,8248,9705,11148,1421,1892
2020-11-14,2783,6480,8710,10948,1241,1542
2020-11-15,2788,5724,8420,13234,1271,1517
2020-11-16,3426,7686,11558,12581,1877,1549
2020-11-17,3611,8103,11530,11520,1788,1823
2020-11-18,3471,7986,10891,12110,1610,1861
2020-11-19,3377,8361,10646,12153,1744,1633
2020-11-20,3278,8735,10551,17386,1702,1576
2020-11-21,3222,6493,9680,10871,1302,1920
2020-11-22,3256,6182,9696,12173,1366,1890
2020-11-23,3897,8946,12652,13990,1823,2074
2020-11-24,3921,9129,12481,11702,1728,2193
2020-11-25,4174,9336,12482,13952,1994,2180
2020-11-26,3984,9079,12245,12225,1899,2085
2020-11-27,3962,9843,12201,12681,1885,2077
2020-11-28,3537,7972,10761,12377,1593,1944
2020-11-29,3405,7135,10709,10983,1455,1950
2020-11-30,4170,10483,13645,16125,2267,1903
2020-12-01,4045,10308,13633,20260,2158,1887
2020-12-02,4177,10270,13485,13341,2043,2134
2020-12-03,4176,10287,13210,12845,2056,2120
2020-12-04,4113,11046,13119,14116,2051,2062
2020-12-05,3661,8726,11427,13926,1643,2018
2020-12-06,3757,7847,11253,12104,1650,2107
2020-12-07,4218,10374,13730,13847,2155,2063
2020-12-08,4400,10502,13894,12907,1970,2430
2020-12-09,4300,11059,14020,12417,2063,2237
2020-12-10,4232,11311,13284,17151,2170,2062
2020-12-11,4006,11060,13362,12346,1926,2080
2020-12-12,3746,9168,11701,12953,1904,1842
2020-12-13,3515,8941,10778,12348,1885,1630
2020-12-14,4345,11115,14366,13381,2332,2013
2020-12-15,4151,11320,13315,13808,2295,1856
2020-12-16,4143,11575,13480,11139,2408,1735
2020-12-17,4184,11586,12804,11622,2233,1951
2020-12-18,4139,12034,12852,13049,2180,1959
2020-12-19,3522,9421,11083,11580,1925,1597
2020-12-20,3867,9208,11451,16232,2047,1820
2020-12-21,4118,11433,13529,12180,2361,1757
2020-12-22,4025,11716,12947,11441,2266,1759
2020-12-23,3964,12984,11898,12941,2347,1617
2020-12-24,3419,11849,10117,13372,2091,1328
2020-12-25,3472,7932,9861,15192,1906,1566
2020-12-26,3829,8221,12176,14010,1932,1897
2020-12-27,3807,8077,11027,13311,1959,1848
2020-12-28,4286,10718,14329,15218,2299,1987
2020-12-29,4075,11456,13256,11792,2618,1457
2020-12-30,4088,12548,12415,13504,2317,1771
2020-12-31,3702,11338,11003,13992,1990,1712
2021-01-01,10,0,41,0,0,10
2021-01-02,31,0,45,0,3,28
2021-01-03,248,28,1184,16662,4,244
2021-01-04,505,139,2196,18208,18,487
2021-01-05,782,337,3303,16588,80,702
2021-01-06,1125,592,4427,14799,75,1050
2021-01-07,1517,912,5632,15264,168,1349
2021-01-08,1544,1224,6685,16298,251,1293
2021-01-09,2060,1426,6833,14602,252,1808
2021-01-10,2261,1849,7581,20542,313,1948
2021-01-11,2795,2605,11050,15059,431,2364
2021-01-12,3138,3296,11274,13909,528,2610
2021-01-13,3426,3770,12523,13280,616,2810
2021-01-14,3792,4730,13112,13919,798,2994
2021-01-15,3806,5368,13192,17329,881,2925
2021-01-16,3600,5071,12508,13305,881,2719
2021-01-17,3533,5009,11983,12732,899,2634
2021-01-18,4286,7110,14623,15902,1149,3137
2021-01-19,4339,7583,14219,12659,1453,2886
2021-01-20,4069,8234,13806,18599,1427,2642
2021-01-21,4258,8402,14143,13214,1410,2848
2021-01-22,4111,9243,13045,13468,1546,2565
2021-01-23,3797,7798,12178,12675,1193,2604
2021-01-24,3593,7615,11633,12843,1533,2060
2021-01-25,4353,9959,14901,16695,1882,2471
2021-01-26,4167,10020,13776,13074,1870,2297
2021-01-27,4040,10124,13424,12422,1828,2212
2021-01-28,4007,10604,13273,13923,2150,1857
2021-01-29,4146,11113,13162,12608,2013,2133
2021-01-30,3650,9379,11584,12304,1896,1754
2021-01-31,3835,8504,11585,13123,1697,2138
2021-02-01,4350,10469,14524,24791,2229,2121
2021-02-02,4386,10946,14138,16454,2040,2346
2021-02-03,4264,10721,14254,14515,2099,2165
2021-02-04,4241,11207,13686,14593,2075,2166
2021-02-05,4245,11404,13561,17287,2172,2073
2021-02-06,3979,9257,12434,14296,1875,2104
2021-02-07,4118,8390,11943,15362,1719,2399
2021-02-08,4431,10741,15055,18509,2473,1958
2021-02-09,4663,11590,14365,16182,2230,2433
2021-02-10,4812,11120,14861,22707,2377,2435
2021-02-11,4507,11621,14637,16613,2447,2060
2021-02-12,4506,12072,15081,20032,2369,2137
2021-02-13,4190,9592,13310,17888,1853,2337
2021-02-14,4490,8887,13279,19531,2001,2489
2021-02-15,5153,11629,16839,25459,2392,2761
2021-02-16,5124,11275,16589,20407,2378,2746
2021-02-17,5041,11783,16952,21287,2518,2523
2021-02-18,5537,12509,17476,24387,2574,2963
2021-02-19,5508,12473,17746,22680,2741,2767
2021-02-20,5394,11152,16652,29887,2354,3040
2021-02-21,5425,10137,16016,21723,2309,3116
2021-02-22,6456,13427,21082,27499,2950,3506
2021-02-23,6537,14167,21064,23032,2988,3549
2021-02-24,6395,13566,21330,23897,3053,3342
2021-02-25,6673,13733,21862,27343,3075,3598
2021-02-26,6923,14985,21559,28018,3002,3921
2021-02-27,6239,12812,20527,25317,2959,3280
2021-02-28,6462,12801,20612,32818,3103,3359
2021-03-01,7732,16025,26047,51983,3809,3923
2021-03-02,8003,16879,26373,31841,3790,4213
2021-03-03,8431,17433,27604,31797,3612,4819
2021-03-04,8244,17490,26850,30854,3812,4432
2021-03-05,8098,18306,26157,36171,3788,4310
2021-03-06,7764,15932,24847,30961,3844,3920
2021-03-07,7463,15709,24894,31643,3761,3702
2021-03-08,8441,20205,30535,38307,4570,3871
2021-03-09,8661,20616,30197,32266,3985,4676
2021-03-10,9574,21279,30902,45398,4612,4962
2021-03-11,9103,21139,30608,31873,4537,4566
2021-03-12,8744,22628,31320,36037,4396,4348
2021-03-13,8663,19955,30029,32255,4279,4384
2021-03-14,8610,19143,28373,32305,4210,4400
2021-03-15,10216,24766,35122,41930,5020,5196
2021-03-16,9759,24254,34128,31483,4928,4831
2021-03-17,9786,24866,33647,31281,5274,4512
2021-03-18,9975,24966,34382,32983,5018,4957
2021-03-19,9492,25302,32346,33234,4761,4731
2021-03-20,9491,23271,30649,40618,5161,4330
2021-03-21,8704,21771,28584,26910,5093,3611
2021-03-22,9974,26638,35702,30481,5442,4532
2021-03-23,10503,27160,35673,28529,5344,5159
2021-03-24,9870,27543,33245,25960,5660,4210
2021-03-25,9789,27825,32036,30011,5489,4300
2021-03-26,9451,27896,31914,27154,5737,3714
2021-03-27,8565,24480,28232,23979,5118,3447
2021-03-28,8266,24129,26998,25626,5221,3045
2021-03-29,9185,28860,32277,24441,5896,3289
2021-03-30,9119,28271,30981,23555,5314,3805
2021-03-31,9007,27748,29130,22094,5386,3621
2021-04-01,9128,27051,28556,38860,5568,3560
2021-04-02,8088,25610,25017,25996,5060,3028
2021-04-03,8049,23622,24620,22564,4887,3162
2021-04-04,7517,22447,23049,24395,4809,2708
2021-04-05,8527,25970,27564,27673,5691,2836
2021-04-06,8735,25711,27458,22701,5413,3322
2021-04-07,8523,25096,26519,22390,5388,3135
2021-04-08,7880,25220,25060,23491,5398,2482
2021-04-09,7760,24576,24090,24145,5127,2633
2021-04-10,7319,21481,21896,30063,4803,2516
2021-04-11,7015,19219,20903,20007,4814,2201
2021-04-12,7777,23561,26149,24788,5187,2590
2021-04-13,7508,22760,24707,20255,4931,2577
2021-04-14,7989,23392,25124,21563,5259,2730
2021-04-15,7501,23254,24249,23658,4846,2655
2021-04-16,7353,22730,23303,21538,4601,2752
2021-04-17,6716,18645,20551,19143,4115,2601
2021-04-18,6498,17527,19395,20678,4175,2323
2021-04-19,7211,21634,23894,22106,5070,2141
2021-04-20,7507,22447,23268,27842,4962,2545
2021-04-21,6695,18823,21266,18683,4484,2211
2021-04-22,7169,21207,22134,19977,4490,2679
2021-04-23,7110,21306,22073,21163,4549,2561
2021-04-24,6699,17420,20049,20721,3994,2705
2021-04-25,6282,16266,19232,22015,4013,2269
2021-04-26,6894,20320,23444,22166,4471,2423
2021-04-27,6750,19642,22729,19407,4318,2432
2021-04-28,6399,18936,20861,20850,4208,2191
2021-04-29,6683,18869,20504,17523,4320,2363
2021-04-30,6360,20788,20383,23620,4025,2335
2021-05-01,6134,16218,18453,32765,3522,2612
2021-05-02,6197,14917,18226,22228,3459,2738
2021-05-03,6642,18018,22724,24290,4223,2419
2021-05-04,7164,18236,22387,21351,4107,3057
2021-05-05,7242,18575,22259,24445,4043,3199
2021-05-06,6584,17900,21622,21607,4035,2549
2021-05-07,6700,18083,21259,24125,4185,2515
2021-05-08,5889,15296,18663,23724,3329,2560
2021-05-09,5950,14720,18182,24025,3162,2788
2021-05-10,6912,17917,23490,35890,3921,2991
2021-05-11,6939,18098,23284,22978,4070,2869
2021-05-12,6808,17457,22691,24743,3981,2827
2021-05-13,6859,17249,22567,23995,3768,3091
2021-05-14,6493,17672,22181,27229,3536,2957
2021-05-15,6508,16033,21169,28129,3733,2775
2021-05-16,6755,14037,20650,23947,3404,3351
2021-05-17,7347,17672,26012,27621,4266,3081
2021-05-18,7438,18750,25923,26312,3950,3488
2021-05-19,7473,18337,25015,23609,3921,3552
2021-05-20,7325,20078,26366,33340,4262,3063
2021-05-21,7279,19349,25608,25437,4001,3278
2021-05-22,6642,16328,22125,23185,3419,3223
2021-05-23,6742,15538,22201,23185,3661,3081
2021-05-24,7508,19210,26895,27081,4165,3343
2021-05-25,7710,20367,26510,29031,4427,3283
2021-05-26,7366,19482,25902,24378,3967,3399
2021-05-27,7257,20114,26253,24357,3950,3307
2021-05-28,7123,20251,25551,27443,4160,2963
2021-05-29,6580,16632,23041,20961,3493,3087
2021-05-30,6690,16483,21968,21842,3767,2923
2021-05-31,6896,19914,25971,24005,4400,2496
2021-06-01,7566,20235,25892,34199,4158,3408
2021-06-02,6878,20621,24804,23687,4127,2751
2021-06-03,7264,19135,24099,22173,3747,3517
2021-06-04,6890,19882,23904,22689,4078,2812
2021-06-05,6520,17557,23091,22213,3770,2750
2021-06-06,6248,16764,22266,21404,3695,2553
2021-06-07,7045,20035,25934,22269,4485,2560
2021-06-08,7119,20082,24635,20471,3966,3153
2021-06-09,6843,20208,24175,18756,4180,2663
2021-06-10,7199,20745,24016,25541,4279,2920
2021-06-11,6352,19954,21954,18721,3748,2604
2021-06-12,5782,17233,19242,18624,3529,2253
2021-06-13,5569,15797,18592,17296,3591,1978
2021-06-14,6416,19095,22843,20392,4134,2282
2021-06-15,6418,19351,21724,19043,4292,2126
2021-06-16,6504,19567,21888,16737,4057,2447
2021-06-17,5843,18368,20236,15635,3794,2049
2021-06-18,5901,18636,19934,18513,3879,2022
2021-06-19,5390,14883,17483,15524,3146,2244
2021-06-20,5048,14085,17295,20207,3353,1695
2021-06-21,5873,16762,20697,16193,3882,1991
2021-06-22,5496,16994,19920,14029,3827,1669
2021-06-23,5363,16809,18526,13821,3712,1651
2021-06-24,5035,16388,17597,13409,3532,1503
2021-06-25,4915,16049,17183,15478,3682,1233
2021-06-26,4902,13581,16035,13762,3031,1871
2021-06-27,4523,12115,14807,12176,2757,1766
2021-06-28,5038,15509,17895,14473,3678,1360
2021-06-29,4952,15121,15779,10739,3279,1673
2021-06-30,4507,15247,14880,13239,3471,1036
